E E E E E E E E E E E E E E E E E E E E E E E E E E E E E E E E
E 0 A A A A A A A A A A A A 3 A A A A A A A A A A A A A A A A E
E E E E E E E E E E E E E E E F W E E E E E E E E E E E E E E E
E W A W A W A W A W A W A W E W F F W A A A A A A F A A A W 5 E
E A W A W A W A W A W A W A E F W A F W A A A A F W F A A F W E
E W A W A W A W A 2 A W A W E W F W A F A A A A F W F A A W F E
E A W A W A W A E E E A W A E F W F W A A A A E A F A A A F W E
E 4 A A A A A A A A A A A A E W F A F W A A E A A A A A A W F E
E E A A A A A A A A A A A A E F W W A F A A A E A A A A A F W E
E E E A A A A A A A A A A A E W F F W A A A A A E A A A A W F E
E E E E A A A A A A A A A A E F W A F W A A A A A A A A A F W E
E E E E E A A E E E E E E E E W F W A F A A A A A A A A A W F E
E E E E E E A A A A A A A A E F W W W W W W W W W W W W W W W E
E E E E E E E A A A A A A A E W F W W W W W W W W W W W W W W E
E E E E E E E E A A A A A A E F W W W W W W W E E E W W W W W E
E E E E E E E E E A A A A A E W F W W W W W E W W W W W W W W E
E E E E E E E E E E E A A A A F 1 W W W W E W W W W W W W W W E
E E E E E E E E E E E E E E E E E E E E E E E E E E E E E E E E
